0 1 h 1 1 0 0 0 0 0
0 c 1 1 1 g 0 0 0 0
0 0 0 0 0 1 0 0 0 0
1 1 g 1 1 1 c 1 0 0
1 0 0 0 0 1 m 1 1 d
g 1 1 1 0 0 0 0 0 0
1 c m m 0 0 0 0 0 0
0 0 0 0 0 0 0 0 0 0
0 0 0 0 0 0 0 0 0 0
0 0 0 0 0 0 0 0 0 0