c 0 h 1 1 1 c 0 1 m
1 1 1 0 0 0 m 0 1 0
1 0 0 0 0 0 0 1 1 0
1 1 1 1 1 1 0 1 0 0
1 0 0 0 0 1 m 1 1 d
1 0 m 0 0 1 0 0 0 0
1 c m c 0 1 1 1 c m
0 0 0 0 0 0 0 0 0 0
0 0 0 0 0 0 0 0 0 0
0 0 0 0 0 0 0 0 0 0